,County,Alleged Victims  of Child Abuse/  Neglect,Alleged Victims in Unconfirmed Investigations,Alleged Victims in Ruled Out Investigations*,Alleged Victims Provided Services**,Alleged Victims Not Provided Services**,Children Removed From Home***
1,ANDERSON,816,550,446,164,652,50
2,ANDREWS,200,134,116,41,159,9
3,ANGELINA,1320,1044,805,105,1215,22
4,ARANSAS,359,234,196,130,229,30
5,ARCHER,74,56,39,9,65,1
6,ARMSTRONG,19,13,5,0,19,0
7,ATASCOSA,787,566,509,199,588,31
8,AUSTIN,250,195,167,43,207,15
9,BAILEY,119,93,86,19,100,0
10,BANDERA,222,154,139,50,172,28
11,BASTROP,1016,778,705,157,859,74
12,BAYLOR,56,29,25,22,34,0
13,BEE,592,416,360,176,416,22
14,BELL,4971,3871,3703,860,4111,380
15,BEXAR,25799,19096,16978,6506,19293,865
16,BLANCO,82,71,64,6,76,3
17,BORDEN,2,2,1,0,2,2
18,BOSQUE,264,203,186,39,225,10
19,BOWIE,1462,1163,887,178,1284,61
20,BRAZORIA,2896,2088,1789,663,2233,126
21,BRAZOS,1779,1310,1063,237,1542,69
22,BREWSTER,71,50,43,23,48,1
23,BRISCOE,17,12,12,3,14,0
24,BROOKS,209,154,151,46,163,5
25,BROWN,598,431,384,120,478,49
26,BURLESON,196,152,144,18,178,10
27,BURNET,480,343,301,75,405,32
28,CALDWELL,522,427,399,65,457,16
29,CALHOUN,205,155,128,35,170,0
30,CALLAHAN,155,89,79,54,101,29
31,CAMERON,7146,4962,4091,2007,5139,214
32,CAMP,236,153,126,56,180,23
33,CARSON,55,50,50,3,52,0
34,CASS,452,366,316,60,392,27
35,CASTRO,82,57,50,10,72,2
36,CHAMBERS,209,143,127,48,161,27
37,CHEROKEE,847,642,576,143,704,35
38,CHILDRESS,111,76,71,17,94,4
39,CLAY,92,64,41,14,78,0
40,COCHRAN,53,45,44,6,47,0
41,COKE,61,44,43,13,48,4
42,COLEMAN,145,69,66,59,86,28
43,COLLIN,4768,3403,2387,899,3869,168
44,COLLINGSWORTH,40,26,22,7,33,0
45,COLORADO,179,137,114,25,154,10
46,COMAL,1087,745,635,315,772,67
47,COMANCHE,180,145,136,22,158,1
48,CONCHO,39,28,26,13,26,1
49,COOKE,535,464,386,56,479,18
50,CORYELL,1335,1051,1006,197,1138,75
51,COTTLE,14,14,8,0,14,0
52,CRANE,30,21,14,6,24,2
53,CROCKETT,61,49,43,13,48,5
54,CROSBY,135,73,51,30,105,6
55,CULBERSON,20,10,9,5,15,0
56,DALLAM,137,87,80,36,101,1
57,DALLAS,24576,18239,14237,4624,19952,1005
58,DAWSON,221,159,144,39,182,3
59,DEAF SMITH,392,269,249,78,314,6
60,DELTA,62,46,43,9,53,0
61,DENTON,4660,3569,2640,741,3919,205
62,DEWITT,229,199,185,27,202,9
63,DICKENS,58,31,31,23,35,7
64,DIMMIT,163,129,121,32,131,25
65,DONLEY,40,17,15,14,26,3
66,DUVAL,223,150,146,69,154,1
67,EASTLAND,255,183,158,69,186,14
68,ECTOR,2268,1604,1365,489,1779,109
69,EDWARDS,43,42,35,10,33,10
70,ELLIS,1309,1000,736,277,1032,40
71,EL PASO,7751,5175,4125,1880,5871,142
72,ERATH,417,269,247,107,310,9
73,FALLS,185,159,149,20,165,2
74,FANNIN,427,364,280,51,376,9
75,FAYETTE,234,162,147,51,183,15
76,FISHER,42,26,23,11,31,0
77,FLOYD,132,103,99,13,119,5
78,FOARD,22,13,10,8,14,0
79,FORT BEND,2880,2235,1751,604,2276,127
80,FRANKLIN,101,77,62,16,85,6
81,FREESTONE,232,180,165,25,207,5
82,FRIO,371,294,273,83,288,10
83,GAINES,140,98,84,26,114,14
84,GALVESTON,3573,2914,2247,648,2925,119
85,GARZA,104,55,50,32,72,5
86,GILLESPIE,137,75,67,35,102,19
87,GLASSCOCK,3,3,3,0,3,0
88,GOLIAD,61,43,38,19,42,3
89,GONZALES,294,242,216,42,252,0
90,GRAY,424,235,155,125,299,49
91,GRAYSON,1843,1477,1190,159,1684,54
92,GREGG,1776,1385,1171,245,1531,51
93,GRIMES,355,283,250,38,317,12
94,GUADALUPE,1633,1252,1107,309,1324,26
95,HALE,533,345,312,127,406,39
96,HALL,51,40,29,6,45,3
97,HAMILTON,127,104,93,5,122,4
98,HANSFORD,39,30,27,3,36,2
99,HARDEMAN,83,55,47,19,64,6
100,HARDIN,670,507,479,51,619,16
101,HARRIS,35729,28256,21715,6990,28739,2109
102,HARRISON,890,653,554,117,773,38
103,HARTLEY,12,9,9,1,11,0
104,HASKELL,76,68,43,10,66,0
105,HAYS,1244,979,893,143,1101,41
106,HEMPHILL,16,13,11,3,13,0
107,HENDERSON,1148,754,632,244,904,77
108,HIDALGO,11471,8492,7024,2101,9370,138
109,HILL,484,359,328,50,434,20
110,HOCKLEY,356,231,219,77,279,10
111,HOOD,785,461,370,187,598,9
112,HOPKINS,466,339,286,78,388,44
113,HOUSTON,315,229,202,44,271,19
114,HOWARD,654,423,361,218,436,36
115,HUDSPETH,26,22,19,3,23,3
116,HUNT,1136,873,686,232,904,109
117,HUTCHINSON,401,319,283,65,336,3
118,IRION,26,22,22,2,24,2
119,JACK,119,77,67,25,94,5
120,JACKSON,188,146,135,31,157,2
121,JASPER,625,484,372,90,535,18
122,JEFF DAVIS,22,18,11,10,12,0
123,JEFFERSON,3069,2405,2076,366,2703,62
124,JIM HOGG,149,67,56,73,76,5
125,JIM WELLS,777,535,490,243,534,43
126,JOHNSON,2103,1366,1082,430,1673,101
127,JONES,237,163,124,46,191,6
128,KARNES,186,169,150,11,175,7
129,KAUFMAN,1087,886,623,145,942,32
130,KENDALL,162,119,107,27,135,9
131,KENEDY,0,0,0,0,0,0
132,KENT,1,1,1,0,1,0
133,KERR,744,540,478,170,574,61
134,KIMBLE,54,34,28,15,39,7
135,KING,0,0,0,0,0,0
136,KINNEY,30,26,26,3,27,0
137,KLEBERG,487,309,288,174,313,40
138,KNOX,43,34,26,8,35,4
139,LAMAR,756,576,512,95,661,27
140,LAMB,251,210,202,23,228,5
141,LAMPASAS,281,234,223,35,246,8
142,LASALLE,123,84,74,40,83,10
143,LAVACA,155,130,125,15,140,3
144,LEE,196,135,117,46,150,13
145,LEON,214,154,115,37,177,0
146,LIBERTY,1005,794,679,176,829,67
147,LIMESTONE,318,264,250,38,280,10
148,LIPSCOMB,34,25,23,4,30,4
149,LIVE OAK,153,117,97,50,103,12
150,LLANO,248,165,155,51,197,18
151,LOVING,0,0,0,0,0,0
152,LUBBOCK,4729,3064,2625,1079,3650,177
153,LYNN,78,67,61,5,73,0
154,MADISON,149,117,110,25,124,5
155,MARION,166,137,108,27,139,9
156,MARTIN,42,25,20,15,27,2
157,MASON,77,52,47,16,61,1
158,MATAGORDA,373,305,222,92,281,5
159,MAVERICK,332,258,239,44,288,6
160,MCCULLOCH,150,101,92,29,121,7
161,MCLENNAN,3835,3097,2829,360,3475,100
162,MCMULLEN,9,6,5,3,6,0
163,MEDINA,623,420,361,215,408,53
164,MENARD,28,24,23,1,27,0
165,MIDLAND,1457,1084,910,261,1196,61
166,MILAM,379,248,232,80,299,39
167,MILLS,63,52,47,5,58,1
168,MITCHELL,149,108,102,24,125,8
169,MONTAGUE,326,203,171,125,201,50
170,MONTGOMERY,3799,2689,2141,1009,2790,342
171,MOORE,296,208,197,43,253,9
172,MORRIS,204,127,103,53,151,20
173,MOTLEY,9,9,9,0,9,1
174,NACOGDOCHES,796,490,414,166,630,67
175,NAVARRO,533,432,323,71,462,15
176,NEWTON,174,140,111,20,154,5
177,NOLAN,365,251,231,77,288,6
178,NUECES,6057,4596,3950,1362,4695,211
179,OCHILTREE,127,108,104,8,119,1
180,OLDHAM,19,17,16,2,17,0
181,ORANGE,1564,1220,954,139,1425,46
182,PALO PINTO,527,352,270,143,384,14
183,PANOLA,308,227,208,27,281,18
184,PARKER,1497,1264,1136,158,1339,21
185,PARMER,83,77,72,5,78,2
186,PECOS,177,111,85,40,137,13
187,POLK,685,512,439,112,573,57
188,POTTER,2978,2013,1633,677,2301,56
189,PRESIDIO,52,36,30,10,42,5
190,RAINS,106,71,61,18,88,8
191,RANDALL,1398,952,799,299,1099,113
192,REAGAN,50,35,32,14,36,3
193,REAL,58,40,38,15,43,7
194,RED RIVER,216,155,122,42,174,10
195,REEVES,113,64,52,28,85,11
196,REFUGIO,57,36,35,23,34,2
197,ROBERTS,2,0,0,1,1,0
198,ROBERTSON,240,204,177,22,218,5
199,ROCKWALL,451,379,261,74,377,7
200,RUNNELS,174,89,75,81,93,13
201,RUSK,664,470,430,73,591,20
202,SABINE,160,116,100,28,132,14
203,SAN AUGUSTINE,71,52,45,14,57,8
204,SAN JACINTO,501,387,328,70,431,19
205,SAN PATRICIO,1142,837,707,329,813,44
206,SAN SABA,79,58,56,20,59,1
207,SCHLEICHER,41,41,41,0,41,0
208,SCURRY,255,174,165,36,219,13
209,SHACKELFORD,26,24,16,3,23,0
210,SHELBY,353,283,240,50,303,28
211,SHERMAN,25,17,17,8,17,4
212,SMITH,1728,1318,1163,300,1428,69
213,SOMERVELL,101,64,44,26,75,9
214,STARR,678,406,365,221,457,31
215,STEPHENS,225,178,155,56,169,3
216,STERLING,10,8,8,0,10,0
217,STONEWALL,9,7,7,0,9,0
218,SUTTON,40,35,33,5,35,0
219,SWISHER,136,84,68,17,119,7
220,TARRANT,22161,15233,10812,4786,17375,740
221,TAYLOR,2179,1491,1278,593,1586,87
222,TERRELL,7,1,0,6,1,4
223,TERRY,270,143,138,99,171,8
224,THROCKMORTON,13,3,1,3,10,0
225,TITUS,500,314,258,122,378,45
226,TOM GREEN,1913,1323,1135,555,1358,116
227,TRAVIS,9278,7276,6364,1066,8212,261
228,TRINITY,188,158,143,11,177,5
229,TYLER,310,266,240,18,292,4
230,UPSHUR,583,443,382,108,475,57
231,UPTON,50,33,20,21,29,4
232,UVALDE,399,322,310,62,337,11
233,VAL VERDE,397,306,285,56,341,11
234,VAN ZANDT,720,450,371,192,528,70
235,VICTORIA,1324,1066,884,263,1061,21
236,WALKER,387,287,226,99,288,40
237,WALLER,393,296,232,84,309,29
238,WARD,167,93,77,69,98,8
239,WASHINGTON,310,236,217,40,270,17
240,WEBB,3350,2532,2292,1051,2299,136
241,WHARTON,385,308,239,89,296,31
242,WHEELER,54,39,35,11,43,6
243,WICHITA,2248,1568,1192,501,1747,91
244,WILBARGER,267,195,124,64,203,5
245,WILLACY,545,375,293,173,372,21
246,WILLIAMSON,2917,2123,1968,425,2492,119
247,WILSON,341,266,227,46,295,20
248,WINKLER,88,60,51,24,64,6
249,WISE,780,617,486,166,614,24
250,WOOD,514,350,311,116,398,47
251,YOAKUM,60,44,34,12,48,3
252,YOUNG,321,235,212,69,252,11
253,ZAPATA,321,218,193,106,215,18
254,ZAVALA,199,161,154,25,174,12
255,UNKNOWN,0,0,0,0,0,1
256,OUT OF STATE,39,30,21,0,39,0
257,STATE TOTAL,288080,213101,175273,57936,230144,12055
