,County,Region,Alleged Victims of Child Abuse/ Neglect,Alleged Victims in Unconfirmed Investigations,Alleged Victims in Ruled Out Investigations*,Alleged Victims Provided Services**,Alleged Victims Not Provided Services**,Children Removed From Home***
1,ANDERSON,004,720,490,426,94,626,36
2,ANDREWS,009,247,180,164,67,180,20
3,ANGELINA,005,1376,985,755,230,1146,77
4,ARANSAS,011,476,319,263,165,311,26
5,ARCHER,002,69,57,55,11,58,2
6,ARMSTRONG,001,11,8,8,6,5,1
7,ATASCOSA,008,698,471,466,189,509,38
8,AUSTIN,006,267,227,204,29,238,8
9,BAILEY,001,89,78,73,4,85,3
10,BANDERA,008,195,145,132,32,163,3
11,BASTROP,007,1152,886,777,143,1009,98
12,BAYLOR,002,73,50,48,3,70,1
13,BEE,011,514,364,328,140,374,36
14,BELL,007,5271,4075,3873,884,4387,413
15,BEXAR,008,23382,17695,16094,4479,18903,942
16,BLANCO,007,103,80,68,17,86,3
17,BORDEN,009,3,3,2,0,3,0
18,BOSQUE,007,223,157,153,46,177,33
19,BOWIE,004,1377,1070,854,173,1204,72
20,BRAZORIA,006,2944,2227,1814,542,2402,52
21,BRAZOS,007,1713,1275,1134,123,1590,21
22,BREWSTER,010,57,40,39,0,57,0
23,BRISCOE,001,19,14,14,3,16,0
24,BROOKS,011,185,148,136,41,144,4
25,BROWN,002,599,404,357,162,437,60
26,BURLESON,007,203,153,151,19,184,15
27,BURNET,007,570,396,369,83,487,47
28,CALDWELL,007,614,398,333,111,503,45
29,CALHOUN,008,261,205,182,44,217,7
30,CALLAHAN,002,207,166,143,33,174,7
31,CAMERON,011,5973,4425,3899,1653,4320,223
32,CAMP,004,201,148,141,27,174,17
33,CARSON,001,41,25,19,10,31,4
34,CASS,004,365,263,231,69,296,51
35,CASTRO,001,42,30,26,13,29,2
36,CHAMBERS,006,361,242,199,90,271,13
37,CHEROKEE,004,744,542,486,135,609,67
38,CHILDRESS,001,84,66,46,14,70,4
39,CLAY,002,116,89,79,19,97,1
40,COCHRAN,001,58,44,44,7,51,0
41,COKE,009,56,41,38,6,50,3
42,COLEMAN,002,122,76,72,32,90,8
43,COLLIN,003,4779,3343,2396,614,4165,215
44,COLLINGSWORTH,001,53,45,35,7,46,2
45,COLORADO,006,169,131,120,22,147,11
46,COMAL,008,1284,759,652,378,906,144
47,COMANCHE,002,146,103,102,25,121,2
48,CONCHO,009,29,24,21,4,25,0
49,COOKE,003,709,471,398,72,637,34
50,CORYELL,007,1358,982,946,224,1134,91
51,COTTLE,002,22,10,9,1,21,0
52,CRANE,009,43,23,17,11,32,0
53,CROCKETT,009,60,48,43,8,52,0
54,CROSBY,001,128,75,62,47,81,11
55,CULBERSON,010,16,7,7,7,9,0
56,DALLAM,001,128,87,73,39,89,11
57,DALLAS,003,23229,16593,13109,4311,18918,1621
58,DAWSON,009,177,140,109,29,148,8
59,DEAF SMITH,001,274,191,178,55,219,19
60,DELTA,004,54,36,30,15,39,5
61,DENTON,003,5189,4160,3274,607,4582,216
62,DE WITT,008,280,207,198,48,232,17
63,DICKENS,001,21,21,13,1,20,0
64,DIMMIT,008,230,179,176,39,191,12
65,DONLEY,001,30,25,22,2,28,0
66,DUVAL,011,149,101,92,42,107,8
67,EASTLAND,002,290,219,204,41,249,10
68,ECTOR,009,2389,1836,1612,332,2057,119
69,EDWARDS,008,26,20,20,5,21,0
70,ELLIS,003,1651,1166,880,349,1302,60
71,EL PASO,010,7780,5574,4837,1522,6258,119
72,ERATH,003,380,232,200,103,277,21
73,FALLS,007,237,174,159,42,195,9
74,FANNIN,003,395,278,233,69,326,15
75,FAYETTE,007,238,161,155,47,191,20
76,FISHER,002,54,26,26,22,32,1
77,FLOYD,001,77,44,39,26,51,10
78,FOARD,002,11,7,7,3,8,0
79,FORT BEND,006,3426,2676,1845,779,2647,85
80,FRANKLIN,004,109,60,46,26,83,12
81,FREESTONE,007,249,204,189,32,217,7
82,FRIO,008,414,282,276,111,303,54
83,GAINES,009,158,122,105,30,128,6
84,GALVESTON,006,3402,2607,2199,770,2632,155
85,GARZA,001,58,38,33,15,43,6
86,GILLESPIE,008,196,119,106,53,143,13
87,GLASSCOCK,009,4,2,2,2,2,0
88,GOLIAD,008,89,79,73,9,80,1
89,GONZALES,008,253,188,172,33,220,5
90,GRAY,001,336,233,161,56,280,13
91,GRAYSON,003,2043,1305,1047,398,1645,85
92,GREGG,004,1845,1219,991,355,1490,124
93,GRIMES,007,307,238,210,45,262,18
94,GUADALUPE,008,1539,1116,1001,210,1329,100
95,HALE,001,514,324,286,115,399,22
96,HALL,001,47,29,21,11,36,2
97,HAMILTON,007,92,71,66,8,84,8
98,HANSFORD,001,52,21,21,21,31,9
99,HARDEMAN,002,62,32,24,9,53,0
100,HARDIN,005,693,534,462,46,647,23
101,HARRIS,006,37176,29946,24466,5634,31542,1309
102,HARRISON,004,909,635,552,131,778,51
103,HARTLEY,001,16,9,5,5,11,0
104,HASKELL,002,68,53,32,7,61,1
105,HAYS,007,1689,1168,978,264,1425,150
106,HEMPHILL,001,27,18,13,8,19,6
107,HENDERSON,004,1337,936,716,281,1056,139
108,HIDALGO,011,10938,8432,7097,2726,8212,177
109,HILL,007,503,363,340,69,434,42
110,HOCKLEY,001,350,268,235,42,308,8
111,HOOD,003,892,597,502,168,724,46
112,HOPKINS,004,563,419,374,89,474,42
113,HOUSTON,005,310,183,171,65,245,35
114,HOWARD,009,483,349,305,107,376,18
115,HUDSPETH,010,20,18,17,0,20,0
116,HUNT,003,1309,913,675,300,1009,157
117,HUTCHINSON,001,325,206,173,84,241,16
118,IRION,009,9,9,7,0,9,0
119,JACK,002,141,81,66,35,106,10
120,JACKSON,008,131,106,99,26,105,3
121,JASPER,005,510,374,321,80,430,39
122,JEFF DAVIS,010,11,9,7,5,6,0
123,JEFFERSON,005,3371,2591,2213,259,3112,119
124,JIM HOGG,011,93,67,58,30,63,0
125,JIM WELLS,011,834,631,572,220,614,25
126,JOHNSON,003,2318,1548,1172,637,1681,124
127,JONES,002,280,198,163,45,235,5
128,KARNES,008,204,145,129,49,155,28
129,KAUFMAN,003,1133,807,644,234,899,46
130,KENDALL,008,227,181,171,25,202,4
131,KENEDY,011,5,3,3,1,4,0
132,KENT,002,10,10,5,0,10,0
133,KERR,008,505,331,291,149,356,41
134,KIMBLE,009,64,49,45,9,55,1
135,KING,001,0,0,0,0,0,0
136,KINNEY,008,25,17,14,2,23,0
137,KLEBERG,011,480,375,341,108,372,14
138,KNOX,002,39,29,20,7,32,0
139,LAMAR,004,886,616,482,169,717,80
140,LAMB,001,252,191,179,26,226,3
141,LAMPASAS,007,327,250,234,57,270,32
142,LA SALLE,008,115,88,84,26,89,5
143,LAVACA,008,157,126,120,24,133,3
144,LEE,007,161,133,130,12,149,13
145,LEON,007,217,191,175,7,210,2
146,LIBERTY,006,1083,761,629,237,846,71
147,LIMESTONE,007,342,272,262,43,299,16
148,LIPSCOMB,001,21,19,16,0,21,0
149,LIVE OAK,011,175,106,95,68,107,16
150,LLANO,007,292,201,195,49,243,35
151,LOVING,009,0,0,0,0,0,0
152,LUBBOCK,001,4250,3002,2645,890,3360,238
153,LYNN,001,59,53,48,2,57,3
154,MADISON,007,154,123,111,15,139,11
155,MARION,004,197,145,117,22,175,11
156,MARTIN,009,41,30,24,8,33,0
157,MASON,009,45,35,30,17,28,2
158,MATAGORDA,006,433,353,319,70,363,15
159,MAVERICK,008,373,334,318,20,353,5
160,MCCULLOCH,009,160,118,109,25,135,3
161,MCLENNAN,007,3798,2611,2411,891,2907,253
162,MCMULLEN,011,19,18,18,5,14,2
163,MEDINA,008,474,390,344,96,378,35
164,MENARD,009,28,22,20,1,27,0
165,MIDLAND,009,1553,1192,1079,196,1357,45
166,MILAM,007,353,215,181,77,276,41
167,MILLS,007,65,43,39,9,56,8
168,MITCHELL,002,127,92,85,30,97,1
169,MONTAGUE,002,346,173,130,99,247,33
170,MONTGOMERY,006,4209,3647,3023,539,3670,130
171,MOORE,001,307,239,206,47,260,10
172,MORRIS,004,164,135,120,20,144,8
173,MOTLEY,001,8,7,7,1,7,2
174,NACOGDOCHES,005,669,490,440,81,588,38
175,NAVARRO,003,651,545,479,80,571,13
176,NEWTON,005,124,99,80,17,107,11
177,NOLAN,002,358,258,231,85,273,11
178,NUECES,011,5750,4273,3539,1438,4312,225
179,OCHILTREE,001,105,70,62,23,82,6
180,OLDHAM,001,12,10,5,2,10,0
181,ORANGE,005,1329,1016,889,198,1131,95
182,PALO PINTO,003,623,345,283,220,403,61
183,PANOLA,004,292,169,120,55,237,20
184,PARKER,003,1511,1005,824,333,1178,61
185,PARMER,001,54,36,33,16,38,9
186,PECOS,009,135,112,100,17,118,4
187,POLK,005,705,586,517,49,656,24
188,POTTER,001,2407,1668,1415,452,1955,125
189,PRESIDIO,010,57,34,33,22,35,2
190,RAINS,004,126,89,87,8,118,5
191,RANDALL,001,1084,759,658,172,912,70
192,REAGAN,009,35,28,24,2,33,2
193,REAL,008,48,35,35,12,36,9
194,RED RIVER,004,148,104,87,26,122,13
195,REEVES,009,137,103,82,18,119,13
196,REFUGIO,011,97,66,49,34,63,8
197,ROBERTS,001,2,1,0,1,1,0
198,ROBERTSON,007,197,157,135,15,182,2
199,ROCKWALL,003,545,408,342,119,426,27
200,RUNNELS,002,159,108,95,38,121,26
201,RUSK,004,720,469,369,154,566,95
202,SABINE,005,127,92,72,9,118,6
203,SAN AUGUSTINE,005,98,70,56,5,93,2
204,SAN JACINTO,005,428,315,299,68,360,25
205,SAN PATRICIO,011,1249,892,775,402,847,43
206,SAN SABA,007,104,64,60,22,82,9
207,SCHLEICHER,009,18,8,6,7,11,4
208,SCURRY,002,310,227,209,81,229,13
209,SHACKELFORD,002,33,23,19,4,29,0
210,SHELBY,005,328,231,189,60,268,33
211,SHERMAN,001,17,11,10,4,13,2
212,SMITH,004,2377,1729,1489,425,1952,192
213,SOMERVELL,003,99,71,56,18,81,3
214,STARR,011,675,539,474,109,566,11
215,STEPHENS,002,154,121,111,13,141,2
216,STERLING,009,29,12,11,11,18,1
217,STONEWALL,002,5,4,2,1,4,0
218,SUTTON,009,27,23,22,4,23,0
219,SWISHER,001,74,39,35,25,49,0
220,TARRANT,003,23061,15947,11858,3577,19484,586
221,TAYLOR,002,2890,1887,1697,731,2159,193
222,TERRELL,009,5,4,3,1,4,0
223,TERRY,001,176,144,140,15,161,1
224,THROCKMORTON,002,26,21,16,7,19,0
225,TITUS,004,323,220,188,68,255,33
226,TOM GREEN,009,1821,1323,1154,400,1421,109
227,TRAVIS,007,12354,9492,8649,1538,10816,595
228,TRINITY,005,236,149,132,50,186,21
229,TYLER,005,346,249,190,47,299,15
230,UPSHUR,004,570,397,364,79,491,34
231,UPTON,009,43,32,28,8,35,1
232,UVALDE,008,439,324,315,107,332,30
233,VAL VERDE,008,479,415,399,29,450,5
234,VAN ZANDT,004,696,486,421,119,577,71
235,VICTORIA,008,1187,911,832,178,1009,23
236,WALKER,006,532,430,358,88,444,14
237,WALLER,006,403,319,292,54,349,19
238,WARD,009,172,143,108,32,140,7
239,WASHINGTON,007,224,148,131,31,193,21
240,WEBB,011,2876,2172,1975,813,2063,155
241,WHARTON,006,413,364,297,48,365,11
242,WHEELER,001,56,44,37,3,53,3
243,WICHITA,002,2320,1558,1260,554,1766,65
244,WILBARGER,002,195,123,97,40,155,7
245,WILLACY,011,428,294,261,145,283,15
246,WILLIAMSON,007,3117,2373,2202,494,2623,110
247,WILSON,008,309,222,199,54,255,23
248,WINKLER,009,89,67,57,13,76,3
249,WISE,003,779,575,502,136,643,58
250,WOOD,004,493,350,283,87,406,32
251,YOAKUM,001,72,56,52,4,68,2
252,YOUNG,002,321,257,230,35,286,9
253,ZAPATA,011,214,174,139,51,163,6
254,ZAVALA,008,262,192,187,65,197,21
255,OUT OF STATE,,62,47,13,1,61,1
256,TOTAL,,290471,215182,181436,52607,237864,13430
